"Account Name : SIMPLE CHECKING"
"Account Number : 67035K90"
"Date Range : 10/01/2024-10/21/2024"
Transaction Number,Date,Description,Memo,Amount Debit,Amount Credit,Balance,Check Number,Fees  
"0000080152427800000008289151000000038487",10/04/2024,"ACH Withdrawal","VIKING RIVER CRU - 8182271234",-384.87,,"8289.15",,
"0000180032427700000008674021000000077848",10/03/2024,"ACH Withdrawal","Apolline Condomi - HOA Dues",-778.48,,"8674.02",,
"0000164682427700000009452501000000200000",10/03/2024,"ACH Withdrawal","WF HOME MTG - AUTO PAY",-2000.00,,"9452.50",,
"0000034402427600000011452501000000874555",10/02/2024,"ACH Withdrawal","VIKING RIVER CRU - 8182271234",-8745.55,,"11452.50",,
"0000009912427600000020198051000000020503",10/02/2024,"ACH Withdrawal","VERIZON WIRELESS - PAYMENTS",-205.03,,"20198.05",,
"0000001692427600000020403080000000674428",10/02/2024,"Payroll Deduction","EMPOWER - EMPOWER",,6744.28,"20403.08",,
"0000072072427500000013658800000001200000",10/01/2024,"Transfer from ******035-00S","Internet Access 10/01/2024 05:33 226823",,12000.00,"13658.80",,
